89,89,89,89,89,89,89,89,89,89
89,33,35,35,35,35,35,35,34,89
89,37,0,0,19,0,0,0,38,89
89,37,0,0,0,0,0,0,38,89
89,37,0,0,58,0,0,0,38,89
89,37,59,0,0,0,10,0,38,89
89,37,0,0,0,0,0,0,38,89
89,37,0,0,29,0,0,10,38,89
89,30,36,36,36,36,36,36,31,89
89,89,89,89,89,89,89,89,89,89

